############
#S         #
## # # ## ##
## # # ## ##
## # # ## ##
## # # ## ##
#       #G##
############
