###############
#S## # ## #  ##
# ## # ## # ###
#    #    # ###
#### # ## # ###
# ## # ## # ###
# ## # ## # ###
# ##       ####
#### # ## # ###
# ## # ## # ###
# ## # ## # ###
#         #G###
###############
