###############
#S## # ## #  ##
# ## # ## # ###
#    #    # ###
#### # ## # ###
# ## # ## # ###
# ## # ## # ###
# ##        ###
#### # ## # ###
# ## # ## # ###
# ## # ## # ###
#         #G###
###############
